Victor_Jerez
1111111111
1        1
1        1
1      R 1
1        1
1        1
1        1
1        1
1        1
1111111111
